....................
....................
......#######.......
....................
...#............#...
....................
...#............#...
....................
...#............#...
....................
....................
....................
......#######.......
....................
....................